############################################################
#..........................................................#
##.###.....................................................#
##.###.....................................................#
#....#.....................................................#
#....#.....................................................#
#....#.....................................................#
####.#.....................................................#
#..........................................................#
#..........................................................#
#..........................................................#
#..........................................................#
#..........................................................#
#..............................#...........................#
#..........................................................#
#..........................................................#
############################################################